
-- 3-stage Johnson Counter

OPTIONS  ff_2in_synchr  solution_first

PARTS  and dff


IN_OUT_SIGNALS
CLK:clk     __==__==__==__==__==__==__==__==__==__==__==__==__;
 --q1       __============____________============____________;
 --q2       ______============____________============________;
 --q3       __________============____________============____;
  1*3       __________====____________________====____________;

END_of_SPEC
